111111111
100000C01
100000001
10C000E01
1P0100001
111111111