11111111111
10000100111
1EP00001101
11010001101
1CC00000101
111100C0C01
110C0C00001
111100C0C01
110C0C00001
111100C0C01
110C0C00001
111100C0C01
110C0C00001
11111111111