111111111111111111111111111111111111111
100000C00000C00000C00000C00000C00000C01
1EP1111111000C00000C00000C00000C00000C1
111111111111111111111111111111111111111