111111111111111
10000010000C001
100C0000P010001
1111110C0011111
1E00000C0011111
111111111111111