111111111
1CCCCCCC1
1ECCCCC11
1CCCCCCP1
111111111