111111111111111
11P00000C010011
111111111111111