11111111111
111C1110101
11E11111111
11111111111