11111111111
1011011CEP1
111111111