111111111
1E1000101
10000C001
110001011
1P0100E01
111111111