1111111111111
0110100010011
111111CEP0001
1110010001111